1 0 4 4 0 1 1 1 1 1 1 1 1 1 1 1 1 0 4 4 0 1 1 1 1 1 1 1 1 1 1 1 1 0 4 4 0 1 1 1 1 1 1 1 1 1 1 1 1 1
1 0 4 4 0 0 0 0 0 0 0 0 0 0 0 1 1 0 4 4 0 1 1 1 1 1 1 1 1 1 1 1 1 0 4 4 0 1 1 1 1 1 1 1 1 1 1 1 1 1
1 0 0 4 4 0 0 0 0 0 4 0 0 0 0 1 1 0 4 4 0 1 1 1 1 1 1 1 1 1 1 1 1 0 4 4 0 1 1 1 1 1 1 1 1 1 1 1 1 1
1 0 0 4 4 0 0 0 0 0 0 0 0 0 0 1 1 0 4 4 0 1 1 1 1 1 1 1 1 1 1 1 1 0 4 4 0 1 1 1 1 1 1 1 1 1 1 1 1 1
1 0 0 4 4 0 0 0 0 0 0 4 0 0 0 1 1 0 4 4 0 1 1 1 1 1 1 1 1 1 1 1 1 0 4 4 0 1 1 1 1 1 1 1 1 1 1 1 1 1
1 0 0 4 4 0 0 0 0 0 0 0 0 5 5 1 1 0 4 4 0 1 1 1 1 1 1 1 1 1 1 1 1 0 4 4 0 1 1 1 1 1 1 1 1 1 1 1 1 1
1 0 0 4 4 0 0 0 0 0 5 5 5 5 2 1 1 0 4 4 0 1 1 1 1 1 1 1 1 1 1 1 1 0 4 4 0 1 1 1 1 1 1 1 1 1 1 1 1 1
1 0 0 4 4 0 0 0 0 5 5 2 2 2 2 1 1 0 4 4 0 1 1 1 1 1 1 1 1 1 1 1 1 0 4 4 0 1 1 1 1 1 1 1 1 1 1 1 1 1
1 0 4 4 4 4 0 0 0 5 2 2 2 2 2 1 1 0 4 4 0 1 1 1 1 1 1 1 1 1 1 1 1 0 4 4 0 1 1 1 1 1 1 1 1 1 1 1 1 1
1 0 3 4 4 3 0 0 0 5 2 2 2 2 2 1 1 0 4 4 0 1 1 1 1 1 1 1 1 1 1 1 1 0 4 4 0 1 1 1 1 1 1 1 1 1 1 1 1 1
1 0 0 0 0 0 0 0 0 5 5 2 2 2 2 1 1 0 4 4 0 1 1 1 1 1 1 1 1 1 1 1 1 0 4 4 0 1 1 1 1 1 1 1 1 1 1 1 1 1
1 1 1 0 0 1 1 1 1 1 1 1 1 1 1 1 1 0 4 4 0 1 1 1 1 1 1 1 1 1 1 1 1 0 4 4 0 1 1 1 1 1 1 1 1 1 1 1 1 1
1 0 4 4 0 1 1 1 1 1 1 1 1 1 1 1 1 0 4 4 0 1 1 1 1 1 1 1 1 1 1 1 1 0 4 4 0 1 1 1 1 1 1 1 1 1 1 1 1 1
1 0 4 4 0 1 0 0 0 0 0 1 0 0 0 1 1 0 4 4 0 1 1 1 1 1 1 1 1 1 1 1 1 0 4 4 0 1 1 1 1 1 1 1 1 1 1 1 1 1
1 0 0 4 4 1 0 0 0 0 4 1 0 0 0 1 1 0 4 4 0 1 1 1 1 1 1 1 1 1 1 1 1 0 4 4 0 1 1 1 1 1 1 1 1 1 1 1 1 1
1 0 0 4 4 1 0 0 0 0 0 1 0 0 0 1 1 0 4 4 0 1 1 1 1 1 1 1 1 1 1 1 1 0 4 4 0 1 1 1 1 1 1 1 1 1 1 1 1 1
1 0 0 4 4 1 0 0 0 0 0 1 0 0 0 1 1 0 4 4 0 1 1 1 1 1 1 1 1 1 1 1 1 0 4 4 0 1 1 1 1 1 1 1 1 1 1 1 1 1
1 0 0 4 4 1 1 1 1 1 1 1 0 5 5 1 1 0 4 4 0 1 1 1 1 1 1 1 1 1 1 1 1 0 4 4 0 1 1 1 1 1 1 1 1 1 1 1 1 1
1 0 0 4 4 0 0 0 0 0 5 5 5 5 2 1 1 0 4 4 0 1 1 1 1 1 1 1 1 1 1 1 1 0 4 4 0 1 1 1 1 1 1 1 1 1 1 1 1 1
1 0 0 4 4 0 0 0 0 5 5 2 2 2 2 1 1 0 4 4 0 1 1 1 1 1 1 1 1 1 1 1 1 0 4 4 0 1 1 1 1 1 1 1 1 1 1 1 1 1
1 0 4 4 4 4 0 0 0 5 2 2 2 2 2 1 1 0 4 4 0 1 1 1 1 1 1 1 1 1 1 1 1 0 4 4 0 1 1 1 1 1 1 1 1 1 1 1 1 1
1 0 3 4 4 3 0 0 0 5 2 2 2 2 2 1 1 0 4 4 0 1 1 1 1 1 1 1 1 1 1 1 1 0 4 4 0 1 1 1 1 1 1 1 1 1 1 1 1 1
1 0 0 0 0 0 0 0 0 5 5 2 2 2 2 1 1 0 4 4 0 1 1 1 1 1 1 1 1 1 1 1 1 0 4 4 0 1 1 1 1 1 1 1 1 1 1 1 1 1
1 1 1 1 1 1 1 1 1 1 1 1 1 1 1 1 1 0 4 4 0 1 1 1 1 1 1 1 1 1 1 1 1 0 4 4 0 1 1 1 1 1 1 1 1 1 1 1 1 1
1 0 4 4 0 1 1 1 1 1 1 1 1 1 1 1 1 0 4 4 0 1 1 1 1 1 1 1 1 1 1 1 1 0 4 4 0 1 1 1 1 1 1 1 1 1 1 1 1 1
1 0 4 4 0 0 0 0 0 0 0 0 0 0 0 1 1 0 4 4 0 1 1 1 1 1 1 1 1 1 1 1 1 0 4 4 0 1 1 1 1 1 1 1 1 1 1 1 1 1
1 0 0 4 4 0 0 0 0 0 4 0 0 0 0 1 1 0 4 4 0 1 1 1 1 1 1 1 1 1 1 1 1 0 4 4 0 1 1 1 1 1 1 1 1 1 1 1 1 1
1 0 0 4 4 0 0 0 0 0 0 0 0 0 0 1 1 0 4 4 0 1 1 1 1 1 1 1 1 1 1 1 1 0 4 4 0 1 1 1 1 1 1 1 1 1 1 1 1 1
1 0 0 4 4 0 0 0 0 0 0 4 0 0 0 1 1 0 4 4 0 1 1 1 1 1 1 1 1 1 1 1 1 0 4 4 0 1 1 1 1 1 1 1 1 1 1 1 1 1
1 0 0 4 4 0 0 0 0 0 0 0 0 5 5 1 1 0 4 4 0 1 1 1 1 1 1 1 1 1 1 1 1 0 4 4 0 1 1 1 1 1 1 1 1 1 1 1 1 1
1 0 0 4 4 0 0 0 0 0 5 5 5 5 2 1 1 0 4 4 0 1 1 1 1 1 1 1 1 1 1 1 1 0 4 4 0 1 1 1 1 1 1 1 1 1 1 1 1 1
1 0 0 4 4 0 0 0 0 5 5 2 2 2 2 1 1 0 4 4 0 1 1 1 1 1 1 1 1 1 1 1 1 0 4 4 0 1 1 1 1 1 1 1 1 1 1 1 1 1
1 0 4 4 4 4 0 0 0 5 2 2 2 2 2 1 1 0 4 4 0 1 1 1 1 1 1 1 1 1 1 1 1 0 4 4 0 1 1 1 1 1 1 1 1 1 1 1 1 1
1 0 3 4 4 3 0 0 0 5 2 2 2 2 2 1 1 0 4 4 0 1 1 1 1 1 1 1 1 1 1 1 1 0 4 4 0 1 1 1 1 1 1 1 1 1 1 1 1 1
1 0 0 0 0 0 0 0 0 5 5 2 2 2 2 1 1 0 4 4 0 1 1 1 1 1 1 1 1 1 1 1 1 0 4 4 0 1 1 1 1 1 1 1 1 1 1 1 1 1
1 1 1 1 1 1 1 1 1 1 1 1 1 1 1 1 1 0 4 4 0 1 1 1 1 1 1 1 1 1 1 1 1 0 4 4 0 1 1 1 1 1 1 1 1 1 1 1 1 1
1 0 4 4 0 1 1 1 1 1 1 1 1 1 1 1 1 0 4 4 0 1 1 1 1 1 1 1 1 1 1 1 1 0 4 4 0 1 1 1 1 1 1 1 1 1 1 1 1 1
1 0 4 4 0 0 0 0 0 0 0 0 0 0 0 1 1 0 4 4 0 1 1 1 1 1 1 1 1 1 1 1 1 0 4 4 0 1 1 1 1 1 1 1 1 1 1 1 1 1
1 0 0 4 4 0 0 0 0 0 4 0 0 0 0 1 1 0 4 4 0 1 1 1 1 1 1 1 1 1 1 1 1 0 4 4 0 1 1 1 1 1 1 1 1 1 1 1 1 1
1 0 0 4 4 0 0 0 0 0 0 0 0 0 0 1 1 0 4 4 0 1 1 1 1 1 1 1 1 1 1 1 1 0 4 4 0 1 1 1 1 1 1 1 1 1 1 1 1 1
1 0 0 4 4 0 0 0 0 0 0 4 0 0 0 1 1 0 4 4 0 1 1 1 1 1 1 1 1 1 1 1 1 0 4 4 0 1 1 1 1 1 1 1 1 1 1 1 1 1
1 0 0 4 4 0 0 0 0 0 0 0 0 5 5 1 1 0 4 4 0 1 1 1 1 1 1 1 1 1 1 1 1 0 4 4 0 1 1 1 1 1 1 1 1 1 1 1 1 1
1 0 0 4 4 0 0 0 0 0 5 5 5 5 2 1 1 0 4 4 0 1 1 1 1 1 1 1 1 1 1 1 1 0 4 4 0 1 1 1 1 1 1 1 1 1 1 1 1 1
1 0 0 4 4 0 0 0 0 5 5 2 2 2 2 1 1 0 4 4 0 1 1 1 1 1 1 1 1 1 1 1 1 0 4 4 0 1 1 1 1 1 1 1 1 1 1 1 1 1
1 0 4 4 4 4 0 0 0 5 2 2 2 2 2 1 1 0 4 4 0 1 1 1 1 1 1 1 1 1 1 1 1 0 4 4 0 1 1 1 1 1 1 1 1 1 1 1 1 1
1 0 3 4 4 3 0 0 0 5 2 2 2 2 2 1 1 0 4 4 0 1 1 1 1 1 1 1 1 1 1 1 1 0 4 4 0 1 1 1 1 1 1 1 1 1 1 1 1 1
1 0 0 0 0 0 0 0 0 5 5 2 2 2 2 1 1 0 4 4 0 1 1 1 1 1 1 1 1 1 1 1 1 0 4 4 0 1 1 1 1 1 1 1 1 1 1 1 1 1
1 1 1 1 1 1 1 1 1 1 1 1 1 1 1 1 1 0 4 4 0 1 1 1 1 1 1 1 1 1 1 1 1 0 4 4 0 1 1 1 1 1 1 1 1 1 1 1 1 1
1 0 4 4 0 1 1 1 1 1 1 1 1 1 1 1 1 0 4 4 0 1 1 1 1 1 1 1 1 1 1 1 1 0 4 4 0 1 1 1 1 1 1 1 1 1 1 1 1 1
1 0 4 4 0 0 0 0 0 0 0 0 0 0 0 1 1 0 4 4 0 1 1 1 1 1 1 1 1 1 1 1 1 0 4 4 0 1 1 1 1 1 1 1 1 1 1 1 1 1